111111111

111111111

100000E01

1P0000C01

111111111
