11111
1P101
101C1
1C0E1
11111
