1111111
1P0C0E1
1010101
1C0C0C1
1111111
