1111111111111111111111111111111111111111111111111
1000001111111111111111111111111111111111111111111
1P0C0E1111111111111111111111111111111111111111111
1000001111111111111111111111111111111111111111111
1111111111111111111111111111111111111111111111111
