11111
1P0C1
10001
1A0E1
11111
