11111
1P0E1
1C001
100C1
111111
